slug	organisation
attorney-generals-office	government-organisation:D1
cabinet-office	government-organisation:D2
department-for-business-innovation-skills	government-organisation:D3
department-for-communities-and-local-government	government-organisation:D4
department-for-culture-media-sport	government-organisation:D5
department-for-education	government-organisation:D6
department-for-environment-food-rural-affairs	government-organisation:D7
department-for-international-development	government-organisation:D8
department-for-transport	government-organisation:D9
department-for-work-pensions	government-organisation:D10
department-of-energy-climate-change	government-organisation:D11
department-of-health	government-organisation:D12
foreign-commonwealth-office	government-organisation:D13
hm-treasury	government-organisation:D15
home-office	government-organisation:D16
ministry-of-defence	government-organisation:D17
ministry-of-justice	government-organisation:D18
northern-ireland-office	government-organisation:D19
office-of-the-advocate-general-for-scotland	government-organisation:D20
the-office-of-the-leader-of-the-house-of-commons	government-organisation:D21
office-of-the-leader-of-the-house-of-lords	government-organisation:D22
scotland-office	government-organisation:D23
office-of-the-secretary-of-state-for-wales	government-organisation:D24
hm-revenue-customs	government-organisation:D25
companies-house	government-organisation:EA26
student-loans-company	government-organisation:PB27
acas	government-organisation:PB28
national-fraud-authority	government-organisation:PB29
treasury-solicitor-s-department	government-organisation:D30
uk-space-agency	government-organisation:EA31
insolvency-service	government-organisation:EA32
national-measurement-office	government-organisation:EA33
intellectual-property-office	government-organisation:EA34
fire-service-college	government-organisation:EA37
ordnance-survey	government-organisation:D38
planning-inspectorate	government-organisation:EA39
queen-elizabeth-ii-conference-centre	government-organisation:EA40
royal-parks	government-organisation:EA41
defence-science-and-technology-laboratory	government-organisation:EA42
defence-support-group	government-organisation:EA44
met-office	government-organisation:EA46
service-children-s-education	government-organisation:EA49
service-personnel-and-veterans-agency	government-organisation:EA50
uk-hydrographic-office	government-organisation:EA51
animal-health-and-veterinary-laboratories-agency	government-organisation:EA52
centre-for-environment-fisheries-and-aquaculture-science	government-organisation:EA53
forest-research	government-organisation:EA54
forest-enterprise-england	government-organisation:EA55
the-food-and-environment-research-agency	government-organisation:EA56
marine-management-organisation	government-organisation:PB57
rural-payments-agency	government-organisation:EA58
veterinary-medicines-directorate	government-organisation:EA60
fco-services	government-organisation:EA61
wilton-park	government-organisation:EA62
medicines-and-healthcare-products-regulatory-agency	government-organisation:EA63
hm-passport-office	government-organisation:EA66
uk-border-agency	government-organisation:EA67
land-registry	government-organisation:D69
national-offender-management-service	government-organisation:EA70
the-national-archives	government-organisation:EA71
office-of-the-public-guardian	government-organisation:EA72
hm-courts-and-tribunals-service	government-organisation:EA73
driver-and-vehicle-licensing-agency	government-organisation:EA74
driving-standards-agency	government-organisation:EA75
highways-agency	government-organisation:EA77
maritime-and-coastguard-agency	government-organisation:EA78
vehicle-and-operator-services-agency	government-organisation:EA79
vehicle-certification-agency	government-organisation:EA80
uk-debt-management-office	government-organisation:EA82
forestry-commission	government-organisation:D85
skills-funding-agency	government-organisation:EA86
valuation-office-agency	government-organisation:EA87
charity-commission	government-organisation:D98
the-crown-estate	government-organisation:OT100
crown-prosecution-service	government-organisation:D101
food-standards-agency	government-organisation:D102
government-actuarys-department	government-organisation:D103
ns-i	government-organisation:EA104
ofsted	government-organisation:D106
ofgem	government-organisation:D108
ofqual	government-organisation:D109
office-of-rail-regulation	government-organisation:D110
royal-mint	government-organisation:EA114
serious-fraud-office	government-organisation:D115
uk-statistics-authority	government-organisation:D116
uk-trade-investment	government-organisation:D117
horserace-betting-levy-board	government-organisation:PB118
higher-education-funding-council-for-england	government-organisation:PB120
council-for-science-and-technology	government-organisation:PB121
low-pay-commission	government-organisation:PB122
arts-and-humanities-research-council	government-organisation:PB123
british-hallmarking-council	government-organisation:PB124
construction-industry-training-board	government-organisation:PB126
economic-and-social-research-council	government-organisation:PB129
engineering-and-physical-sciences-research-council	government-organisation:PB130
engineering-construction-industry-training-board	government-organisation:PB131
medical-research-council	government-organisation:PB132
natural-environment-research-council	government-organisation:PB133
office-for-fair-access	government-organisation:PB134
science-and-technology-facilities-council	government-organisation:PB135
technology-strategy-board	government-organisation:PB136
uk-atomic-energy-authority	government-organisation:PB137
uk-commission-for-employment-and-skills	government-organisation:PB138
certification-officer	government-organisation:PB139
competition-appeal-tribunal	government-organisation:PB140
capital-for-enterprise-ltd	government-organisation:PB147
central-arbitration-committee	government-organisation:PB148
industrial-development-advisory-board	government-organisation:OT152
the-committee-on-standards-in-public-life	government-organisation:PB158
building-regulations-advisory-committee	government-organisation:PB160
homes-and-communities-agency	government-organisation:PB161
architects-registration-board	government-organisation:PC163
arts-council-england	government-organisation:PB165
british-library	government-organisation:PB166
british-museum	government-organisation:PB167
english-heritage	government-organisation:PB168
gambling-commission	government-organisation:PB169
geffrye-museum	government-organisation:PB170
horniman-museum	government-organisation:PB171
imperial-war-museum	government-organisation:PB172
national-gallery	government-organisation:PB174
national-heritage-memorial-fund	government-organisation:PB175
science-museum-group	government-organisation:PB177
national-museums-liverpool	government-organisation:PB178
national-portrait-gallery	government-organisation:PB179
natural-history-museum	government-organisation:PB180
olympic-delivery-authority	government-organisation:PB181
royal-armouries-museum	government-organisation:PB182
sir-john-soane-s-museum	government-organisation:PB183
sports-grounds-safety-authority	government-organisation:PB184
uk-sport	government-organisation:PB185
visitbritain	government-organisation:PB186
wallace-collection	government-organisation:PB187
big-lottery-fund	government-organisation:PB188
british-film-institute	government-organisation:PB189
sport-england	government-organisation:PB190
committee-on-radioactive-waste-management	government-organisation:PB191
the-fuel-poverty-advisory-group	government-organisation:PB192
nuclear-liabilities-financing-assurance-board	government-organisation:PB193
civil-nuclear-police-authority	government-organisation:PB194
the-coal-authority	government-organisation:PB195
committee-on-climate-change	government-organisation:PB196
nuclear-decommissioning-authority	government-organisation:PB197
consumer-council-for-water	government-organisation:PB198
environment-agency	government-organisation:EA199
gangmasters-licensing-authority	government-organisation:PB200
joint-nature-conservation-committee	government-organisation:PB201
natural-england	government-organisation:PB202
agriculture-and-horticulture-development-board	government-organisation:OT204
sea-fish-industry-authority	government-organisation:OT205
health-and-safety-executive	government-organisation:PB207
advisory-committee-on-pesticides	government-organisation:PB208
advisory-committee-on-releases-to-the-environment	government-organisation:PB209
independent-agricultural-appeals-panel	government-organisation:PB210
science-advisory-council	government-organisation:PB211
veterinary-products-committee	government-organisation:PB212
covent-garden-market-authority	government-organisation:OT214
broads-authority	government-organisation:OT216
dartmoor-national-park-authority	government-organisation:OT217
exmoor-national-park-authority	government-organisation:OT219
lake-district-national-park-authority	government-organisation:OT220
new-forest-national-park-authority	government-organisation:OT222
north-york-moors-national-park	government-organisation:OT223
commonwealth-scholarship-commission-in-the-uk	government-organisation:PB226
equality-2025	government-organisation:PB230
industrial-injuries-advisory-council	government-organisation:PB231
social-security-advisory-committee	government-organisation:PB232
the-pensions-advisory-service	government-organisation:PB233
the-pensions-regulator	government-organisation:PB234
pension-protection-fund-ombudsman	government-organisation:PB235
pensions-ombudsman	government-organisation:PB236
national-employment-savings-trust	government-organisation:OT237
the-water-services-regulation-authority	government-organisation:D240
uk-export-finance	government-organisation:D241
education-funding-agency	government-organisation:EA242
standards-and-testing-agency	government-organisation:EA243
children-and-family-court-advisory-and-support-service	government-organisation:PB246
disabled-persons-transport-advisory-committee	government-organisation:PB247
air-accidents-investigation-branch	government-organisation:OT248
rail-accident-investigation-branch	government-organisation:OT249
care-quality-commission	government-organisation:PB251
human-fertilisation-and-embryology-authority	government-organisation:PB253
human-tissue-authority	government-organisation:PB254
monitor	government-organisation:PB255
foreign-compensation-commission	government-organisation:PB257
uk-financial-investments-limited	government-organisation:PC259
office-for-budget-responsibility	government-organisation:PB260
office-of-tax-simplification	government-organisation:OT261
office-of-the-immigration-services-commissioner	government-organisation:PB263
security-industry-authority	government-organisation:PB264
serious-organised-crime-agency	government-organisation:PB265
office-of-manpower-economics	government-organisation:PB266
equality-and-human-rights-commission	government-organisation:OT269
investigatory-powers-tribunal	government-organisation:PB270
advisory-council-on-the-misuse-of-drugs	government-organisation:PB271
police-advisory-board-for-england-and-wales	government-organisation:PB273
technical-advisory-board	government-organisation:PB274
migration-advisory-committee	government-organisation:PB275
national-dna-database-ethics-group	government-organisation:PB276
police-arbitration-tribunal	government-organisation:PB277
police-discipline-appeals-tribunal	government-organisation:PB278
hm-inspectorate-of-constabulary	government-organisation:OT281
independent-chief-inspector-of-borders-and-immigration	government-organisation:OT284
royal-naval-museum	government-organisation:PB290
royal-museums-greenwich	government-organisation:PB291
civil-justice-council	government-organisation:PB293
law-commission	government-organisation:PB294
the-sentencing-council-for-england-and-wales	government-organisation:PB295
victim-s-advisory-panel	government-organisation:PB296
criminal-injuries-compensation-authority	government-organisation:PB297
information-commissioner-s-office	government-organisation:PB298
judicial-appointments-commission	government-organisation:PB299
legal-services-commission	government-organisation:PB300
parole-board	government-organisation:PB301
youth-justice-board-for-england-and-wales	government-organisation:PB302
office-for-national-statistics	government-organisation:D303
the-security-service-mi5	government-organisation:OT304
secret-intelligence-service	government-organisation:OT305
government-communications-headquarters	government-organisation:OT306
national-army-museum	government-organisation:PB307
royal-air-force-museum	government-organisation:PB308
royal-marines-museum	government-organisation:PB310
fleet-air-arm-museum	government-organisation:PB311
british-council	government-organisation:OT313
marshall-aid-commemoration-commission	government-organisation:OT315
westminster-foundation-for-democracy	government-organisation:OT316
biotechnology-biological-sciences-research-council	government-organisation:PB317
competition-service	government-organisation:PB318
criminal-cases-review-commission	government-organisation:IM320
hm-prison-service	government-organisation:EA321
hm-inspectorate-of-prisons	government-organisation:IM324
hm-inspectorate-of-probation	government-organisation:IM325
victims-commissioner	government-organisation:PB326
prisons-and-probation-ombudsman	government-organisation:IM327
official-solicitor-and-public-trustee	government-organisation:OT328
the-legal-ombudsman	government-organisation:IM329
legal-services-board	government-organisation:IM332
judicial-appointments-and-conduct-ombudsman	government-organisation:IM333
independent-commission-for-aid-impact	government-organisation:IM335
advisory-committee-on-business-appointments	government-organisation:PB336
boundary-commission-for-england	government-organisation:PB337
house-of-lords-appointments-commission	government-organisation:IM341
privy-council-office	government-organisation:OT342
audit-commission	government-organisation:PC343
hm-crown-prosecution-service-inspectorate	government-organisation:OT347
pension-protection-fund	government-organisation:PB348
independent-living-fund	government-organisation:PB349
remploy-ltd	government-organisation:PB350
office-of-fair-trading	government-organisation:D352
competition-commission	government-organisation:PB353
regulatory-policy-committee	government-organisation:PB354
copyright-tribunal	government-organisation:PB355
consumer-focus	government-organisation:PB356
export-guarantees-advisory-council	government-organisation:PB357
land-registration-rule-committee	government-organisation:PB358
uk-green-investment-bank	government-organisation:OT360
government-procurement-service	government-organisation:EA365
civil-service-commission	government-organisation:PB366
security-vetting-appeals-panel	government-organisation:PB367
review-body-on-senior-salaries	government-organisation:PB368
housing-ombudsman	government-organisation:PB372
leasehold-advisory-service	government-organisation:PB373
london-thames-gateway-development-corporation	government-organisation:PB374
valuation-tribunal-service-for-england-valuation-tribunal-service	government-organisation:PB375
visitengland	government-organisation:PB376
uk-anti-doping	government-organisation:PB377
victoria-and-albert-museum	government-organisation:PB378
the-theatres-trust	government-organisation:PB380
the-reviewing-committee-on-the-export-of-works-of-art-and-objects-of-cultural-interest	government-organisation:PB382
treasure-valuation-committee	government-organisation:PB383
ofcom	government-organisation:OT385
channel-4	government-organisation:PC386
s4c	government-organisation:PC387
bbc	government-organisation:PC388
historic-royal-palaces	government-organisation:PC389
heritage-lottery-fund	government-organisation:PC390
advisory-committee-on-conscientious-objectors	government-organisation:PB392
advisory-group-on-military-medicine	government-organisation:PB393
armed-forces-pay-review-body	government-organisation:PB394
central-advisory-committee-on-pensions-and-compensation	government-organisation:PB395
defence-nuclear-safety-committee	government-organisation:PB396
defence-scientific-advisory-council	government-organisation:PB397
national-employer-advisory-board	government-organisation:PB399
nuclear-research-advisory-council	government-organisation:PB400
oil-and-pipelines-agency	government-organisation:PB401
science-advisory-committee-on-the-medical-implications-of-less-lethal-weapons	government-organisation:PB402
veterans-advisory-and-pensions-committees-x13	government-organisation:PB403
service-complaints-commissioner	government-organisation:OT404
defence-academy	government-organisation:OT405
service-prosecuting-authority	government-organisation:OT406
defence-press-and-broadcasting-advisory-committee	government-organisation:OT408
royal-navy-submarine-museum	government-organisation:OT409
defence-sixth-form-college	government-organisation:OT411
office-of-the-children-s-commissioner	government-organisation:PB413
school-teachers-review-body	government-organisation:PB414
national-forest-company	government-organisation:PB415
agricultural-wages-committee-x13	government-organisation:PB420
agricultural-dwelling-house-advisory-committees-x16	government-organisation:PB421
plant-varieties-and-seeds-tribunal	government-organisation:PB423
drinking-water-inspectorate	government-organisation:OT425
great-britain-china-centre	government-organisation:PB426
bbc-world-service	government-organisation:PC427
boundary-commission-for-northern-ireland	government-organisation:OT428
northern-ireland-human-rights-commission	government-organisation:OT429
parades-commission-for-northern-ireland	government-organisation:OT430
boundary-commission-for-scotland	government-organisation:OT431
boundary-commission-for-wales	government-organisation:OT432
the-adjudicator-s-office	government-organisation:OT433
royal-mint-advisory-committee	government-organisation:PB434
supreme-court-of-the-united-kingdom	government-organisation:D435
administrative-justice-and-tribunals-council	government-organisation:PB436
advisory-committees-on-justices-of-the-peace	government-organisation:PB437
the-advisory-council-on-national-records-and-archives	government-organisation:PB438
civil-procedure-rules-committee	government-organisation:PB440
family-justice-council	government-organisation:PB441
family-procedure-rule-committee	government-organisation:PB442
independent-advisory-panel-on-deaths-in-custody	government-organisation:PB443
independent-monitoring-boards-of-prisons-immigration-removal-centres-and-short-term-holding-rooms	government-organisation:OT444
insolvency-rules-committee	government-organisation:PB445
prison-services-pay-review-body	government-organisation:PB446
tribunal-procedure-committee	government-organisation:PB448
independent-police-complaint-commission	government-organisation:PB456
office-of-surveillance-commissioners	government-organisation:PB457
police-negotiating-board	government-organisation:PB458
directly-operated-railways-limited	government-organisation:PB459
high-speed-two-limited	government-organisation:PB460
british-transport-police-authority	government-organisation:PB461
trinity-house	government-organisation:PB462
northern-lighthouse-board	government-organisation:PB463
passenger-focus	government-organisation:PB464
traffic-commissioners	government-organisation:PB465
railway-heritage-committee	government-organisation:PB466
brb-residuary-ltd	government-organisation:PC467
trust-ports	government-organisation:PC468
civil-aviation-authority	government-organisation:PC469
marine-accident-investigation-branch	government-organisation:PC472
national-institute-for-clinical-excellence	government-organisation:PB474
review-board-for-government-contracts	government-organisation:PB477
public-health-england	government-organisation:EA480
nhs-commissioning-board	government-organisation:PB481
health-research-authority	government-organisation:OT483
nhs-trust-development-authority	government-organisation:OT484
nhs-blood-and-transplant	government-organisation:OT486
nhs-litigation-authority	government-organisation:OT488
advisory-panel-on-public-sector-information	government-organisation:PB491
chevening-foundation	government-organisation:OT492
london-and-continental-railways-ltd	government-organisation:PC493
airports-commission	government-organisation:OT494
defence-equipment-and-support	government-organisation:OT495
defence-infrastructure-organisation	government-organisation:OT496
joint-forces-command	government-organisation:OT498
the-shareholder-executive	government-organisation:PB500
the-west-northamptonshire-development-corporation	government-organisation:PB501
office-for-life-sciences	government-organisation:OT502
local-government-ombudsman	government-organisation:PB503
chief-fire-and-rescue-adviser-unit	government-organisation:OT504
national-security	government-organisation:OT505
government-equalities-office	government-organisation:OT506
efficiency-and-reform-group	government-organisation:OT507
board-of-trustees-of-the-royal-botanic-gardens-kew	government-organisation:PB508
disclosure-and-barring-service	government-organisation:PB509
social-mobility-and-child-poverty-commission	government-organisation:PB510
independent-reviewer-of-terrorism-legislation	government-organisation:OT511
intelligence-services-commissioner	government-organisation:OT512
interception-of-communications-commissioner	government-organisation:OT513
office-for-low-emission-vehicles	government-organisation:OT514
office-of-the-parliamentary-counsel	government-organisation:OT515
criminal-procedure-rule-committee	government-organisation:PB516
commissioner-for-public-appointments	government-organisation:OT517
mckay-commission	government-organisation:OT518
the-parliamentary-and-health-service-ombudsman	government-organisation:OT519
behavioural-insights-team	government-organisation:OT520
insolvency-practitioners-tribunal	government-organisation:PB521
advisory-committee-on-clinical-excellence-awards	government-organisation:OT522
administration-of-radioactive-substances-advisory-committee	government-organisation:PB523
british-pharmacopoeia	government-organisation:PB524
commission-on-human-medicines	government-organisation:PB525
committee-on-mutagenicity-of-chemicals-in-food-consumer-products-and-the-environment	government-organisation:PB526
independent-reconfiguration-panel	government-organisation:PB527
nhs-business-services-authority	government-organisation:OT529
review-body-on-doctors-and-dentists-remuneration	government-organisation:PB530
nhs-pay-review-body	government-organisation:PB531
prime-ministers-office-10-downing-street	government-organisation:OT532
investigation-into-the-role-of-jimmy-savile-at-broadmoor-hospital	government-organisation:OT533
animals-in-science-committee	government-organisation:PB534
border-force	government-organisation:OT535
forensic-science-regulator	government-organisation:OT536
deputy-prime-ministers-office	government-organisation:OT537
health-and-social-care-information-centre	government-organisation:OT538
health-education-england	government-organisation:OT539
infrastructure-uk	government-organisation:OT540
national-college-for-teaching-and-leadership	government-organisation:EA541
northumberland-national-park-authority	government-organisation:OT543
peak-district-national-park	government-organisation:OT545
south-downs-national-park-authority	government-organisation:OT546
yorkshire-dales-national-park-authority	government-organisation:OT547
biometrics-commissioner	government-organisation:OT548
government-estates-management	government-organisation:OT549
competition-and-markets-authority	government-organisation:D550
groceries-code-adjudicator	government-organisation:OT551
surveillance-camera-commissioner	government-organisation:OT552
office-of-the-regulator-of-community-interest-companies	government-organisation:OT553
uk-visas-and-immigration	government-organisation:OT554
government-office-for-science	government-organisation:OT555
legal-aid-agency	government-organisation:EA556
export-control-organisation	government-organisation:OT557
national-crime-agency	government-organisation:PB558
healthcare-uk	government-organisation:OT559
cesg	government-organisation:OT563
bona-vacantia	government-organisation:OT564
morecambe-bay-investigation	government-organisation:OT565
open-public-services	government-organisation:OT566
centre-for-the-protection-of-national-infrastructure	government-organisation:OT567
better-regulation-delivery-office	government-organisation:OT569
driver-and-vehicle-standards-agency	government-organisation:EA570
tate	government-organisation:PB571
wave-hub	government-organisation:OT572
advisory-committee-on-animal-feedingstuffs	government-organisation:PB573
advisory-committee-on-novel-foods-and-processes	government-organisation:PB574
advisory-committee-on-the-microbiological-safety-of-food	government-organisation:PB575
committee-on-toxicity-of-chemicals-in-food-consumer-products-and-the-environment	government-organisation:PB576
general-advisory-committee-on-science	government-organisation:PB577
social-science-research-committee	government-organisation:PB578
independent-case-examiner	government-organisation:OT579
national-crime-agency-remuneration-review-body	government-organisation:PB580
queens-harbour-master	government-organisation:OT581
scottish-office	government-organisation:D582
department-for-education-and-skills	government-organisation:D583
department-of-social-security	government-organisation:D584
department-of-education	government-organisation:D585
department-of-trade-and-industry	government-organisation:D586
department-for-constitutional-affairs	government-organisation:D587
firearms-consultative-committee	government-organisation:OT588
animal-procedures-committee	government-organisation:OT589
welsh-office	government-organisation:OT590
department-of-the-environment	government-organisation:D591
monopolies-and-mergers-commission	government-organisation:OT592
royal-commission-on-criminal-justice	government-organisation:OT593
board-of-inland-revenue	government-organisation:OT594
lord-chancellors-department	government-organisation:D595
victoria-climbi_-inquiry	government-organisation:OT596
shipman-inquiry	government-organisation:OT597
department-of-constitutional-affairs	government-organisation:D598
kerr-haslam-inquiry	government-organisation:OT599
office-of-the-legal-services-complaints-commissioner	government-organisation:OT600
hm-court-service	government-organisation:EA601
review-body-for-nursing-and-other-health-professions	government-organisation:OT604
department-of-finance-and-personnel-for-northern-ireland	government-organisation:D605
royal-commission-on-environmental-pollution	government-organisation:OT606
department-for-innovation-universities-and-skills	government-organisation:D608
department-for-children-schools-and-families	government-organisation:D609
office-for-criminal-justice-reform	government-organisation:OT610
department-for-business-enterprise-and-regulatory-reform	government-organisation:D611
scottish-law-commission	government-organisation:OT612
statistics-commission	government-organisation:OT614
independent-monitoring-commission	government-organisation:OT615
independent-review-of-the-uk-postal-services-sector	government-organisation:OT616
office-of-hm-paymaster-general	government-organisation:OT618
independent-review-of-police-officer-and-staff-remuneration-and-conditions	government-organisation:OT619
royal-liverpool-childrens-inquiry	government-organisation:OT622
qualifications-and-curriculum-authority	government-organisation:EA624
gaming-board-for-great-britain	government-organisation:OT626
public-accounts-commission	government-organisation:OT627
derby-north-east-education-action-zone	government-organisation:OT628
national-care-standards-commission	government-organisation:OT629
rivers-agency	government-organisation:EA630
department-of-inland-revenue	government-organisation:D631
kitts-green-and-shard-end-education-action-zone	government-organisation:OT632
nhs-pensions-agency	government-organisation:EA633
northern-ireland-audit-office	government-organisation:OT634
equitable-life-inquiry	government-organisation:OT635
office-of-the-police-ombudsman-for-northern-ireland	government-organisation:OT636
greenwich-education-action-zone	government-organisation:OT637
wolverhampton-education-action-zone	government-organisation:OT638
wednesbury-education-action-zone	government-organisation:OT639
bolton-education-action-zone	government-organisation:OT640
hamilton-oxford-education-action-zone	government-organisation:OT641
scottish-screen	government-organisation:OT642
dudley-education-action-zone	government-organisation:OT643
northern-ireland-council-for-the-curriculum-examinations-and-assessment	government-organisation:OT644
westminster-education-action-zone	government-organisation:OT645
north-east-derbyshire-coalfields-education-action-zone	government-organisation:OT646
telford-and-wrekin-education-action-zone	government-organisation:OT647
withernsea-and-southern-holderness-education-action-zone	government-organisation:OT648
northern-ireland-policing-board	government-organisation:OT649
easington-and-seaham-education-action-zone	government-organisation:OT650
north-islington-education-action-zone	government-organisation:OT651
stoke-education-action-zone	government-organisation:OT652
sunderland-education-action-zone	government-organisation:OT653
peterlee-education-action-zone	government-organisation:OT654
southend-education-action-zone	government-organisation:OT655
national-biological-standards-board	government-organisation:EA656
police-service-of-northern-ireland	government-organisation:OT657
national-endowment-for-science-technology-and-the-arts	government-organisation:OT658
probation-board-for-northern-ireland	government-organisation:OT659
public-health-laboratory-service-board	government-organisation:EA660
parliamentary-contributory-pension-fund	government-organisation:OT661
bedford-education-action-zone	government-organisation:OT662
leigh-park-education-action-zone	government-organisation:OT663
downham-and-bellingham-education-action-zone	government-organisation:OT664
corby-education-action-zone	government-organisation:OT665
bristol-education-action-zone	government-organisation:OT666
north-west-shropshire-education-action-zone	government-organisation:OT667
wythenshawe-education-action-zone	government-organisation:OT668
ellesmere-port-education-action-zone	government-organisation:OT669
camborne-pool-and-redruth-education-action-zone	government-organisation:OT670
coventry-education-action-zone	government-organisation:OT671
north-gillingham-education-action-zone	government-organisation:OT672
gloucester-education-action-zone	government-organisation:OT673
east-manchester-education-action-zone	government-organisation:OT674
northern-ireland-social-security-agency	government-organisation:EA675
commission-for-racial-equality	government-organisation:OT676
clacton-and-harwich-education-action-zone	government-organisation:OT677
hackney-education-action-zone	government-organisation:OT678
hastings-and-st-leonards-education-action-zone	government-organisation:OT679
kent-and-somerset-education-action-zone	government-organisation:OT680
hybu-cig-cymru-meat-promotion-wales	government-organisation:OT681
commission-for-health-improvement	government-organisation:OT683
bridgwater-education-action-zone	government-organisation:OT684
defence-analytical-services-agency	government-organisation:EA685
hm-inspectorate-of-explosives-for-northern-ireland	government-organisation:OT686
valuation-and-lands-agency	government-organisation:EA687
sentence-review-commissioners	government-organisation:OT688
water-service-northern-ireland	government-organisation:EA689
counter-fraud-and-security-management-service	government-organisation:OT690
family-health-services-appeal-authority	government-organisation:OT691
national-treatment-agency-for-substance-misuse	government-organisation:EA692
ministry-of-defence-police-and-guarding-agency	government-organisation:EA693
sports-council-for-northern-ireland	government-organisation:OT694
ordnance-survey-of-northern-ireland	government-organisation:EA695
forensic-science-northern-ireland	government-organisation:EA696
youth-justice-agency-of-northern-ireland	government-organisation:EA697
assets-recovery-agency	government-organisation:EA698
land-registers-of-northern-ireland	government-organisation:EA700
northern-ireland-statistics-and-research-agency	government-organisation:EA701
dingle-granby-toxteth-education-action-zone	government-organisation:OT702
national-crime-squad	government-organisation:OT703
national-criminal-intelligence-service	government-organisation:EA704
medical-supplies-agency	government-organisation:EA705
armed-forces-personnel-administration-agency	government-organisation:EA706
compensation-agency	government-organisation:EA707
wakefield-education-action-zone	government-organisation:OT708
nhs-estates	government-organisation:OT709
equal-opportunities-commission	government-organisation:OT710
disability-rights-commission	government-organisation:OT711
national-weights-and-measures-laboratory	government-organisation:OT712
defence-estates	government-organisation:OT713
planning-service	government-organisation:OT714
general-teaching-council-for-england	government-organisation:EA715
nhs-purchasing-and-supply-agency	government-organisation:EA716
defence-aviation-repair-agency	government-organisation:EA717
uk-passport-service	government-organisation:OT718
millennium-commission	government-organisation:OT719
defence-intelligence-and-security-centre	government-organisation:OT720
alcohol-education-and-research-council	government-organisation:OT721
south-east-sheffield-education-action-zone	government-organisation:OT722
national-probation-service	government-organisation:OT723
hearing-aid-council	government-organisation:OT724
northern-ireland-court-service	government-organisation:EA725
criminal-records-bureau	government-organisation:OT726
police-complaints-authority	government-organisation:OT727
countryside-agency	government-organisation:EA729
national-radiological-protection-board	government-organisation:OT730
arts-council-of-wales	government-organisation:OT731
consumer-council-for-postal-services	government-organisation:OT732
gas-and-electricity-consumer-council-energywatch	government-organisation:OT733
sports-council-for-wales	government-organisation:OT734
warship-support-agency	government-organisation:EA735
great-yarmouth-education-action-zone	government-organisation:OT736
south-east-england-virtual-education-action-zone	government-organisation:OT737
heart-of-slough-education-action-zone	government-organisation:OT738
plymouth-education-action-zone	government-organisation:OT739
arts-council-of-northern-ireland	government-organisation:EA740
general-social-care-council	government-organisation:OT741
hm-customs-and-excise	government-organisation:OT742
community-fund	government-organisation:OT743
office-of-the-chief-electoral-officer-for-northern-ireland	government-organisation:OT744
office-of-the-oversight-commissioner	government-organisation:OT745
department-of-health-social-services-and-public-safety	government-organisation:D746
department-for-regional-development	government-organisation:D747
department-for-social-development	government-organisation:D748
office-of-the-first-minister-and-deputy-first-minister	government-organisation:OT749
department-of-enterprise-trade-and-investment	government-organisation:D750
staff-commission-for-education-and-library-boards	government-organisation:OT751
labour-relations-agency	government-organisation:EA752
department-of-agriculture-and-rural-development	government-organisation:D753
crown-agents-holding-and-realisation-board	government-organisation:OT754
social-security-agency	government-organisation:EA756
home-grown-cereals-authority	government-organisation:OT757
northern-ireland-local-government-officers-superannuation-committee	government-organisation:OT758
fire-authority-for-northern-ireland	government-organisation:OT759
community-development-foundation	government-organisation:OT760
northern-ireland-authority-for-energy-regulation	government-organisation:OT761
scottish-arts-council	government-organisation:OT762
scottish-sports-council	government-organisation:EA764
learning-and-skills-council	government-organisation:EA765
barrow-education-action-zone	government-organisation:OT766
speke-garston-education-action-zone	government-organisation:OT767
east-cleveland-education-action-zone	government-organisation:OT768
armagh-observatory-and-planetarium	government-organisation:OT769
northern-ireland-social-care-council	government-organisation:OT770
building-research-establishment	government-organisation:EA771
criminal-justice-inspection-northern-ireland	government-organisation:OT772
deepcut-review	government-organisation:OT773
national-blood-authority	government-organisation:OT774
uk-transplant	government-organisation:OT775
south-bradford-education-action-zone	government-organisation:OT776
north-stockton-education-action-zone	government-organisation:OT777
council-for-catholic-maintained-schools	government-organisation:OT778
equality-commission-for-northern-ireland	government-organisation:OT779
court-of-judicature-of-northern-ireland	government-organisation:OT780
north-east-education-and-library-board	government-organisation:OT781
zahid-mubarek-inquiry	government-organisation:OT782
northern-ireland-legal-services-commission	government-organisation:OT783
veterinary-laboratories-agency	government-organisation:EA784
defence-procurement-agency	government-organisation:EA785
adult-learning-inspectorate	government-organisation:OT786
football-licensing-authority	government-organisation:OT787
environment-and-heritage-service	government-organisation:EA788
defence-storage-and-distribution-agency	government-organisation:EA789
training-and-development-agency-for-schools	government-organisation:EA790
northern-ireland-health-and-social-services-estates-agency	government-organisation:EA791
health-protection-agency	government-organisation:EA792
food-from-britain	government-organisation:OT793
strategic-rail-authority	government-organisation:OT794
special-eu-programmes-body	government-organisation:OT795
business-development-service	government-organisation:OT796
northern-ireland-prison-service	government-organisation:EA797
dental-practice-board	government-organisation:OT798
dental-vocational-training-authority	government-organisation:OT799
mental-health-act-commission	government-organisation:OT800
nhs-appointments-commission	government-organisation:OT801
nhs-direct-national-health-service-trust	government-organisation:OT802
nhs-institute-for-innovation-and-improvement	government-organisation:OT803
nhs-logistics-authority	government-organisation:OT804
nhs-professionals	government-organisation:OT805
prescription-pricing-authority	government-organisation:OT806
fisheries-conservancy-board-for-northern-ireland	government-organisation:OT807
driver-and-vehicle-testing-agency	government-organisation:EA808
general-consumer-council-for-northern-ireland	government-organisation:OT809
northern-ireland-child-support-agency	government-organisation:EA810
hm-inspectorate-of-court-administration	government-organisation:OT811
forensic-science-service	government-organisation:OT812
defence-communication-services-agency	government-organisation:EA813
council-for-healthcare-regulatory-excellence	government-organisation:OT814
army-base-repair-organisation	government-organisation:EA816
ogcbuyingsolutions	government-organisation:OT817
disability-and-carers-service	government-organisation:OT818
central-police-training-and-development-authority	government-organisation:OT819
northern-ireland-tourist-board	government-organisation:OT820
central-science-laboratory	government-organisation:EA821
commission-for-patient-and-public-involvement-in-health	government-organisation:OT822
disposal-services-agency	government-organisation:EA823
commission-for-social-care-inspection	government-organisation:OT824
forest-service	government-organisation:OT825
public-lending-right-office	government-organisation:OT826
office-of-the-legal-services-ombudsman	government-organisation:OT827
northern-ireland-ombudsman	government-organisation:OT828
criminal-injuries-compensation-appeals-panel-for-northern-ireland	government-organisation:EA829
government-car-and-despatch-agency	government-organisation:EA830
roads-service	government-organisation:OT831
police-information-technology-organisation	government-organisation:EA832
english-nature	government-organisation:EA833
postal-services-commission	government-organisation:OT834
housing-corporation	government-organisation:EA835
defence-medical-education-and-training-agency	government-organisation:EA836
criminal-injuries-compensation-appeals-panel	government-organisation:OT837
northern-ireland-commissioner-for-children-and-young-people	government-organisation:OT838
thurrock-thames-gateway-development-corporation	government-organisation:OT840
council-for-the-central-laboratory-of-the-research-councils	government-organisation:OT841
commission-for-architecture-and-the-built-environment-cabe	government-organisation:PB842
marine-fisheries-agency	government-organisation:EA843
uk-government-decontamination-service	government-organisation:EA844
pension-service	government-organisation:OT845
central-office-of-information	government-organisation:OT846
appeals-service-agency	government-organisation:EA847
defence-transport-and-movements-agency	government-organisation:EA848
livestock-and-meat-commission-for-northern-ireland	government-organisation:OT849
uk-film-council	government-organisation:OT850
milk-development-council	government-organisation:OT851
new-opportunities-fund	government-organisation:OT852
department-of-culture-arts-and-leisure	government-organisation:D853
department-for-employment-and-learning	government-organisation:D854
northern-ireland-practice-and-education-council	government-organisation:OT856
south-eastern-education-and-library-board	government-organisation:OT857
western-education-and-library-board	government-organisation:OT858
state-veterinary-service	government-organisation:OT859
national-patient-safety-agency	government-organisation:EA860
ashington-education-action-zone	government-organisation:OT861
loughs-agency	government-organisation:OT862
northern-health-and-social-services-board	government-organisation:OT863
southern-health-and-social-services-board	government-organisation:OT864
eastern-health-and-social-services-board	government-organisation:OT865
western-health-and-social-services-board	government-organisation:OT866
revenue-and-customs-prosecutions-office	government-organisation:OT867
national-museums-and-galleries-of-northern-ireland	government-organisation:OT868
waterways-ireland	government-organisation:OT869
food-safety-promotion-board	government-organisation:PB870
enterprise-ulster	government-organisation:OT871
pesticides-safety-directorate	government-organisation:OT872
meat-hygiene-service	government-organisation:EA873
english-partnerships	government-organisation:EA874
particle-physics-and-astronomy-research-council	government-organisation:OT875
meat-and-livestock-commission	government-organisation:OT876
life-sentence-review-commissioners	government-organisation:OT877
british-forces-post-office	government-organisation:OT878
rent-service	government-organisation:EA879
northern-ireland-judicial-appointments-commission	government-organisation:OT880
people-pay-and-pensions-agency	government-organisation:EA882
defence-bills-agency	government-organisation:EA883
defence-vetting-agency	government-organisation:EA884
identity-and-passport-service	government-organisation:OT885
english-sports-council	government-organisation:OT886
british-potato-council	government-organisation:OT887
healthcare-commission	government-organisation:OT889
commission-for-rural-communities	government-organisation:OT890
national-school-of-government	government-organisation:OT891
design-council	government-organisation:OT893
standards-board-for-england	government-organisation:OT895
investors-in-people-uk	government-organisation:OT896
postgraduate-medical-education-and-training-board	government-organisation:OT897
nhs-information-centre	government-organisation:OT899
animal-health	government-organisation:EA900
renewable-fuels-agency	government-organisation:EA901
horticultural-development-council	government-organisation:OT902
personal-accounts-delivery-authority	government-organisation:OT903
national-policing-improvement-agency	government-organisation:EA904
sutherland-inquiry	government-organisation:OT905
professional-oversight-board	government-organisation:OT906
wales-audit-office	government-organisation:OT908
commission-for-the-compact	government-organisation:OT909
phoenix-sports	government-organisation:OT910
buying-solutions	government-organisation:OT911
east-midlands-development-agency-emda	government-organisation:EA912
parole-commissioners-for-northern-ireland	government-organisation:OT913
independent-safeguarding-authority	government-organisation:OT914
childrens-workforce-development-council	government-organisation:OT915
local-better-regulation-office	government-organisation:OT916
east-of-england-development-agency	government-organisation:EA917
south-west-of-england-regional-development-agency	government-organisation:EA918
south-east-england-development-agency	government-organisation:EA919
northwest-regional-development-agency	government-organisation:EA920
one-north-east	government-organisation:EA921
northwest-business-link	government-organisation:EA922
yorkshire-forward	government-organisation:EA923
pension-disability-and-carers-service	government-organisation:EA924
icl-inquiry	government-organisation:OT925
child-maintenance-and-enforcement-commission	government-organisation:OT926
advantage-west-midlands	government-organisation:EA927
capacitybuilders	government-organisation:OT928
national-college-for-school-leadership	government-organisation:EA929
working-ventures-uk	government-organisation:OT930
british-educational-communications-and-technology-agency	government-organisation:EA932
nimrod-review	government-organisation:OT933
tenant-services-authority	government-organisation:EA934
northern-ireland-police-fund	government-organisation:OT935
museums-libraries-and-archives-council	government-organisation:OT936
northern-ireland-law-commission	government-organisation:OT937
school-food-trust	government-organisation:OT938
office-of-the-commissioner-for-the-rights-of-trade-union-members	government-organisation:OT940
office-of-the-commissioner-for-protection-against-unlawful-industrial-action	government-organisation:OT941
bloody-sunday-inquiry	government-organisation:OT944
office-of-the-health-professions-adjudicator	government-organisation:OT945
royal-trustees-office	government-organisation:OT946
infrastructure-planning-commission	government-organisation:OT947
asset-protection-agency	government-organisation:EA949
co2sense	government-organisation:OT950
billy-wright-inquiry	government-organisation:OT951
redfern-inquiry	government-organisation:OT952
sitpro	government-organisation:OT953
rosemary-nelson-inquiry	government-organisation:OT954
office-for-tenants-and-social-landlords	government-organisation:EA955
qualifications-and-curriculum-development-agency	government-organisation:EA956
english-institute-of-sport	government-organisation:OT957
mull-of-kintyre-review	government-organisation:OT958
north-west-development-agency	government-organisation:EA959
young-peoples-learning-agency	government-organisation:EA960
firebuy	government-organisation:OT961
public-prosecution-service-for-northern-ireland	government-organisation:OT962
baha-mousa-inquiry	government-organisation:OT963
creative-scotland	government-organisation:OT964
hillsborough-independent-panel	government-organisation:OT966
leveson-inquiry	government-organisation:OT967
patrick-finucane-review	government-organisation:OT968
mid-staffordshire-nhs-foundation-trust-public-inquiry	government-organisation:OT969
royal-mail	government-organisation:PC970
professional-standards-authority-for-health-and-social-care	government-organisation:OT971
azelle-rodney-inquiry	government-organisation:OT972
council-on-tribunals	government-organisation:PB973
exchequer-and-audit-department	government-organisation:D974
nature-conservancy-council	government-organisation:OT975
office-of-the-lay-observer	government-organisation:OT976
office-of-telecommunications	government-organisation:OT977
oftel	government-organisation:OT978
office-of-the-data-protection-registrar	government-organisation:OT979
polytechnics-and-colleges-funding-council	government-organisation:OT980
inquiry-into-the-supervision-of-the-bank-of-credit-and-commerce-international	government-organisation:OT984
national-museums-of-scotland	government-organisation:OT987
ancient-monuments-board-for-scotland	government-organisation:OT988
scottish-hospital-trust	government-organisation:OT989
welsh-development-agency	government-organisation:OT991
chemical-and-biological-defence-establishment	government-organisation:OT992
department-of-national-heritage	government-organisation:OT993
legal-aid-board	government-organisation:OT994
independent-television-commission	government-organisation:OT995
board-of-banking-supervision	government-organisation:OT996
her-majestys-magistrates-courts-service-inspectorate	government-organisation:OT997
examination-team-on-child-care-procedures-and-practice-in-north-wales	government-organisation:OT998
natural-resources-institute	government-organisation:OT999
further-and-higher-education-funding-councils-for-wales	government-organisation:OT1000
broadcasting-standards-commission	government-organisation:OT1001
department-of-the-environment-transport-and-the-regions	government-organisation:OT1002
northern-ireland-judicial-appointments-ombudsman	government-organisation:OT1003
united-kingdom-blood-transfusion-services	government-organisation:OT1004
gowers-review-of-intellectual-property	government-organisation:OT1005
barker-review-of-land-use-planning	government-organisation:OT1006
leitch-review-of-skills	government-organisation:OT1007
cooksey-review	government-organisation:OT1008
varney-review	government-organisation:OT1009
eliasch-review	government-organisation:OT1010
veterinary-residues-committee	government-organisation:OT1011
administrative-justice-and-tribunals-council-welsh-committee	government-organisation:OT1012
lyons-inquiry-into-local-government	government-organisation:OT1013
office-of-the-identity-commissioner	government-organisation:OT1014
crown-commercial-service	government-organisation:EA1015
bank-of-england	government-organisation:OT1016
independent-medical-expert-group	government-organisation:PB1017
mid-staffordshire-nhs-foundation-trust-public-inquiry-2010	government-organisation:OT1018
welsh-government	government-organisation:DA1019
the-scottish-government	government-organisation:DA1020
northern-ireland-executive	government-organisation:DA1021
uk-co-ordinating-body	government-organisation:OT1022
hm-nautical-almanac-office	government-organisation:OT1023
academy-for-justice-commissioning	government-organisation:OT1025
uk-trade-and-investment-defence-and-security-organisation	government-organisation:OT1026
office-of-the-schools-adjudicator	government-organisation:OT1027
civil-service	government-organisation:CS1028
civil-service-operational-delivery-profession	government-organisation:OT1029
civil-service-policy-profession	government-organisation:OT1030
civil-service-project-delivery-profession	government-organisation:OT1031
civil-service-procurement-profession	government-organisation:OT1032
civil-service-government-legal-service	government-organisation:OT1033
civil-service-government-communication-service	government-organisation:OT1034
civil-service-government-finance-profession	government-organisation:OT1035
civil-service-human-resources-profession	government-organisation:OT1036
civil-service-government-economic-service	government-organisation:OT1037
civil-service-internal-audit-profession	government-organisation:OT1038
civil-service-government-property-profession	government-organisation:OT1039
civil-service-government-science-engineering	government-organisation:OT1040
civil-service-government-statistical-service	government-organisation:OT1041
civil-service-government-operational-research-service	government-organisation:OT1042
civil-service-government-social-research-profession	government-organisation:OT1043
civil-service-the-government-planning-profession	government-organisation:OT1044
civil-service-government-planning-inspectors	government-organisation:OT1045
civil-service-government-tax-profession	government-organisation:OT1046
civil-service-government-veterinary-services	government-organisation:OT1047
civil-service-government-knowledge-information-management-profession	government-organisation:OT1048
civil-service-government-occupational-psychology-profession	government-organisation:OT1049
civil-service-corporate-finance-profession-cfp	government-organisation:OT1050
british-cattle-movement-service	government-organisation:OT1051
civil-service-intelligence-analysis-profession	government-organisation:OT1052
civil-service-government-it-profession	government-organisation:OT1053
civil-service-medical-profession	government-organisation:OT1054
civil-service-reform	government-organisation:OT1055
government-digital-service	government-organisation:OT1056
macur-review	government-organisation:OT1057
jeffrey-review	government-organisation:OT1058
office-for-nuclear-regulation	government-organisation:PC1059
rural-development-programme-for-england-network	government-organisation:OT1060
government-chemist	government-organisation:OT1061
company-names-tribunal	government-organisation:PB1062
civil-nuclear-constabulary	government-organisation:OT1063
centre-for-defence-enterprise	government-organisation:OT1064
reserve-forces-and-cadets-associations	government-organisation:OT1065
office-for-disability-issues	government-organisation:OT1066
ukti-education	government-organisation:OT1067
ukti-life-sciences-organisation	government-organisation:OT1068
immigration-enforcement	government-organisation:OT1069
government-security-profession	government-organisation:OT1070
military-aviation-authority	government-organisation:OT1071
agri-food-and-biosciences-institute	government-organisation:PB1072
department-of-justice-northern-ireland	government-organisation:D1073
information-services-division-scotland	government-organisation:OT1074
national-records-of-scotland	government-organisation:OT1075
civil-service-resourcing	government-organisation:OT1076
public-health-wales	government-organisation:OT1077
innovate-uk	government-organisation:PB1078
animal-and-plant-health-agency	government-organisation:EA1079
district-valuer-services-dvs	government-organisation:OT1080
regeneration-investment-organisation	government-organisation:OT1081
financial-services-organisation	government-organisation:OT1082
police-remuneration-review-body	government-organisation:PB1083
government-internal-audit-agency	government-organisation:EA1084
financial-conduct-authority	government-organisation:OT1085
stabilisation-unit	government-organisation:OT1086
veterans-uk	government-organisation:OT1087
higher-education-statistical-agency	government-organisation:OT1088
national-counter-terrorism-security-office	government-organisation:OT1089
national-information-board	government-organisation:OT1090
office-of-the-registrar-of-consultant-lobbyists	government-organisation:OT1091
single-source-regulations-office	government-organisation:PB1093
independent-complaints-reviewer	government-organisation:OT1099
court-of-protection	government-organisation:OT1100
welsh-language-commissioner	government-organisation:OT1101
careers-wales	government-organisation:OT1102
natural-resources-wales	government-organisation:OT1103
nhs-wales-informatics-service	government-organisation:OT1104
estyn	government-organisation:DA1105
schools-commissioners-group	government-organisation:OT1107
government-legal-department	government-organisation:D1108
national-measurement-and-regulation-office	government-organisation:EA1109
third-party-campaigning-review	government-organisation:OT1111
united-kingdom-reserve-forces-association	government-organisation:OT1112
defence-electronics-and-components-agency	government-organisation:EA1113
highways-england	government-organisation:EA1114
government-commercial-function	government-organisation:OT1116
office-of-rail-and-road	government-organisation:D1117
transport-focus	government-organisation:PB1118
oil-and-gas-authority	government-organisation:EA1119
bankruptcy-court	government-organisation:CO1120
civil-service-fast-stream	government-organisation:OT1121
independent-family-returns-panel	government-organisation:OT1122
independent-anti-slavery-commissioner	government-organisation:IM1123
first-tier-tribunal-mental-health	government-organisation:CO1124
first-tier-tribunal-general-regulatory-chamber	government-organisation:CO1125
first-tier-tribunal-war-pensions-and-armed-forces-compensation	government-organisation:CO1126
first-tier-tribunal-asylum-support	government-organisation:CO1127
first-tier-tribunal-tax	government-organisation:CO1128
gangmasters-licensing-appeals	government-organisation:CO1129
first-tier-tribunal-criminal-injuries-compensation	government-organisation:CO1130
first-tier-tribunal-care-standards	government-organisation:CO1131
employment-tribunal	government-organisation:CO1133
employment-appeal-tribunal	government-organisation:CO1134
senior-courts-costs-office	government-organisation:CO1135
first-tier-tribunal-social-security-and-child-support	government-organisation:CO1136
accelerated-access-review	government-organisation:OT1137
reserve-forces-appeal-tribunal	government-organisation:PB1138
first-tier-tribunal-property-chamber	government-organisation:PB1139
upper-tribunal-tax-and-chancery-chamber	government-organisation:PB1140
upper-tribunal-lands-chamber	government-organisation:PB1141
upper-tribunal-administrative-appeals-chamber	government-organisation:PB1142
first-tier-tribunal-immigration-and-asylum	government-organisation:PB1143
upper-tribunal-immigration-and-asylum-chamber	government-organisation:PB1144
first-tier-tribunal-special-educational-needs-and-disability	government-organisation:CO1145
department-of-culture-arts-and-leisure-northern-ireland	government-organisation:DA1146
admiralty-court	government-organisation:CO1147
british-business-bank	government-organisation:OT1148
independent-commission-on-freedom-of-information	government-organisation:PB1149
radioactive-waste-management	government-organisation:OT1150
payment-systems-regulator	government-organisation:OT1151
disabled-peoples-employment-corporation	government-organisation:PB1152
defence-and-security-media-advisory-committee	government-organisation:OT1153
ebbsfleet-development-corporation	government-organisation:PB1154
family-division-of-the-high-court	government-organisation:CO1155
planning-court	government-organisation:CO1156
technology-and-construction-court	government-organisation:CO1157
mercantile-court	government-organisation:CO1158
commercial-court	government-organisation:CO1159
companies-court	government-organisation:CO1160
national-infrastructure-commission	government-organisation:OT1161
intellectual-property-enterprise-court	government-organisation:CO1162
court-of-appeal-civil-division	government-organisation:CO1163
historic-england	government-organisation:PB1164
northampton-county-court-business-centre	government-organisation:CO1165
infrastructure-and-projects-authority	government-organisation:OT1166
civil-service-fast-track-apprenticeship	government-organisation:OT1167
service-complaints-ombudsman	government-organisation:OT1168
financial-services-trade-and-investment-board	government-organisation:OT1169
patents-court	government-organisation:CO1170
uk-holocaust-memorial-foundation	government-organisation:PB1171
committee-on-fuel-poverty	government-organisation:PB1172
department-for-communities-northern-ireland	government-organisation:OT1173
department-for-the-economy-northern-ireland	government-organisation:OT1174
department-of-health-northern-ireland	government-organisation:OT1175
department-for-infrastructure-northern-ireland	government-organisation:OT1176
department-of-finance-northern-ireland	government-organisation:OT1177
department-of-agriculture-environment-and-rural-affairs-northern-ireland	government-organisation:OT1178
the-executive-office-northern-ireland	government-organisation:OT1179
national-data-guardian	government-organisation:OT1180
court-of-appeal-criminal-division	government-organisation:CO1181
digital-data-and-technology-professions	government-organisation:OT1182
queens-bench-division-of-the-high-court	government-organisation:CO1183
porton-biopharma-limited	government-organisation:OT1184
dormant-assets-commission	government-organisation:PB1185
uk-government-investments	government-organisation:OT1186
office-of-financial-sanctions-implementation	government-organisation:OT1187
administrative-court	government-organisation:CO1188
regulatory-delivery	government-organisation:OT1189
lammy-review	government-organisation:OT1190
defence-safety-authority	government-organisation:OT1191
pubs-code-adjudicator	government-organisation:OT1192
social-mobility-commission	government-organisation:PB1193
central-advisory-committee-on-compensation	government-organisation:PB1194
iraq-inquiry	government-organisation:OT1195
department-for-international-trade	government-organisation:D1196
department-for-exiting-the-european-union	government-organisation:D1197
department-for-business-energy-and-industrial-strategy	government-organisation:D1198
nhs-improvement	government-organisation:PB1199
civil-service-board	government-organisation:OT1200
cabinet-office-board	government-organisation:OT1201
nhs-digital	government-organisation:PB1202
the-electoral-commission	government-organisation:IM1203
valuation-tribunal-for-england	government-organisation:PB1204
chancery-division-of-the-high-court	government-organisation:CO1205
defence-and-security-accelerator	government-organisation:OT1206
rail-safety-and-standards-board	government-organisation:OT1207
academy-for-social-justice-commissioning	government-organisation:OT1208
her-majestys-government-communications-centre	government-organisation:OT1209
preventing-sexual-violence-initiative	government-organisation:OT1210
national-cyber-security-centre	government-organisation:OT1211
northern-ireland-housing-executive	government-organisation:PB1212
her-majestys-prison-and-probation-service	government-organisation:EA1213
institute-for-apprenticeships	government-organisation:PB1214
judicial-office	government-organisation:OT1215
education-and-skills-funding-agency	government-organisation:EO1216
regulator-of-social-housing	government-organisation:PB1218
